1111111111111
100000000P001
100E000C00001
1110000000001
1111111111111